1	0	0	3840	3840	
11	0	1920	1920	1920	
12	1920	1920	1920	1920	
13	0	0	1920	1920	
131	0	960	960	960	
1311	0	1440	480	480	
1312	480	1440	480	480	
1313	0	960	480	480	0	1	2	3	4	5	6	50	51	52	53	54	55	56	100	101	102	103	104	105	106	150	151	152	153	154	155	156	200	201	202	203	204	205	206	250	251	252	253	254	255	256	300	301	302	303	304	305	306	
1314	480	960	480	480	7	8	9	10	11	12	13	14	57	58	59	60	61	62	63	64	107	108	109	110	111	112	113	114	157	158	159	160	161	162	163	164	207	208	209	210	211	212	213	214	257	258	259	260	261	262	263	264	307	308	309	310	311	312	313	314	
132	960	960	960	960	
1321	960	1440	480	480	
1322	1440	1440	480	480	
1323	960	960	480	480	14	15	16	17	18	19	20	21	64	65	66	67	68	69	70	71	114	115	116	117	118	119	120	121	164	165	166	167	168	169	170	171	214	215	216	217	218	219	220	221	264	265	266	267	268	269	270	271	314	315	316	317	318	319	320	321	
1324	1440	960	480	480	22	23	24	25	26	27	28	29	72	73	74	75	76	77	78	79	122	123	124	125	126	127	128	129	172	173	174	175	176	177	178	179	222	223	224	225	226	227	228	229	272	273	274	275	276	277	278	279	322	323	324	325	326	327	328	329	
133	0	0	960	960	
1331	0	480	480	480	300	301	302	303	304	305	306	350	351	352	353	354	355	356	400	401	402	403	404	405	406	450	451	452	453	454	455	456	500	501	502	503	504	505	506	550	551	552	553	554	555	556	600	601	602	603	604	605	606	650	651	652	653	654	655	656	
1332	480	480	480	480	307	308	309	310	311	312	313	314	357	358	359	360	361	362	363	364	407	408	409	410	411	412	413	414	457	458	459	460	461	462	463	464	507	508	509	510	511	512	513	514	557	558	559	560	561	562	563	564	607	608	609	610	611	612	613	614	657	658	659	660	661	662	663	664	
1333	0	0	480	480	700	701	702	703	704	705	706	750	751	752	753	754	755	756	800	801	802	803	804	805	806	850	851	852	853	854	855	856	900	901	902	903	904	905	906	950	951	952	953	954	955	956	1000	1001	1002	1003	1004	1005	1006	
1334	480	0	480	480	707	708	709	710	711	712	713	714	757	758	759	760	761	762	763	764	807	808	809	810	811	812	813	814	857	858	859	860	861	862	863	864	907	908	909	910	911	912	913	914	957	958	959	960	961	962	963	964	1007	1008	1009	1010	1011	1012	1013	1014	
134	960	0	960	960	
1341	960	480	480	480	314	315	316	317	318	319	320	321	364	365	366	367	368	369	370	371	414	415	416	417	418	419	420	421	464	465	466	467	468	469	470	471	514	515	516	517	518	519	520	521	564	565	566	567	568	569	570	571	614	615	616	617	618	619	620	621	664	665	666	667	668	669	670	671	
1342	1440	480	480	480	322	323	324	325	326	327	328	329	372	373	374	375	376	377	378	379	422	423	424	425	426	427	428	429	472	473	474	475	476	477	478	479	522	523	524	525	526	527	528	529	572	573	574	575	576	577	578	579	622	623	624	625	626	627	628	629	672	673	674	675	676	677	678	679	
1343	960	0	480	480	714	715	716	717	718	719	720	721	764	765	766	767	768	769	770	771	814	815	816	817	818	819	820	821	864	865	866	867	868	869	870	871	914	915	916	917	918	919	920	921	964	965	966	967	968	969	970	971	1014	1015	1016	1017	1018	1019	1020	1021	
1344	1440	0	480	480	722	723	724	725	726	727	728	729	772	773	774	775	776	777	778	779	822	823	824	825	826	827	828	829	872	873	874	875	876	877	878	879	922	923	924	925	926	927	928	929	972	973	974	975	976	977	978	979	1022	1023	1024	1025	1026	1027	1028	1029	
14	1920	0	1920	1920	
141	1920	960	960	960	
1411	1920	1440	480	480	
1412	2400	1440	480	480	
1413	1920	960	480	480	29	30	31	32	33	34	35	36	79	80	81	82	83	84	85	86	129	130	131	132	133	134	135	136	179	180	181	182	183	184	185	186	229	230	231	232	233	234	235	236	279	280	281	282	283	284	285	286	329	330	331	332	333	334	335	336	
1414	2400	960	480	480	37	38	39	40	41	42	43	44	87	88	89	90	91	92	93	94	137	138	139	140	141	142	143	144	187	188	189	190	191	192	193	194	237	238	239	240	241	242	243	244	287	288	289	290	291	292	293	294	337	338	339	340	341	342	343	344	
142	2880	960	960	960	
1421	2880	1440	480	480	
1422	3360	1440	480	480	
1423	2880	960	480	480	44	45	46	47	48	49	94	95	96	97	98	99	144	145	146	147	148	149	194	195	196	197	198	199	244	245	246	247	248	249	294	295	296	297	298	299	344	345	346	347	348	349	
1424	3360	960	480	480	
143	1920	0	960	960	
1431	1920	480	480	480	329	330	331	332	333	334	335	336	379	380	381	382	383	384	385	386	429	430	431	432	433	434	435	436	479	480	481	482	483	484	485	486	529	530	531	532	533	534	535	536	579	580	581	582	583	584	585	586	629	630	631	632	633	634	635	636	679	680	681	682	683	684	685	686	
1432	2400	480	480	480	337	338	339	340	341	342	343	344	387	388	389	390	391	392	393	394	437	438	439	440	441	442	443	444	487	488	489	490	491	492	493	494	537	538	539	540	541	542	543	544	587	588	589	590	591	592	593	594	637	638	639	640	641	642	643	644	687	688	689	690	691	692	693	694	
1433	1920	0	480	480	729	730	731	732	733	734	735	736	779	780	781	782	783	784	785	786	829	830	831	832	833	834	835	836	879	880	881	882	883	884	885	886	929	930	931	932	933	934	935	936	979	980	981	982	983	984	985	986	1029	1030	1031	1032	1033	1034	1035	1036	
1434	2400	0	480	480	737	738	739	740	741	742	743	744	787	788	789	790	791	792	793	794	837	838	839	840	841	842	843	844	887	888	889	890	891	892	893	894	937	938	939	940	941	942	943	944	987	988	989	990	991	992	993	994	1037	1038	1039	1040	1041	1042	1043	1044	
144	2880	0	960	960	
1441	2880	480	480	480	344	345	346	347	348	349	394	395	396	397	398	399	444	445	446	447	448	449	494	495	496	497	498	499	544	545	546	547	548	549	594	595	596	597	598	599	644	645	646	647	648	649	694	695	696	697	698	699	
1442	3360	480	480	480	
1443	2880	0	480	480	744	745	746	747	748	749	794	795	796	797	798	799	844	845	846	847	848	849	894	895	896	897	898	899	944	945	946	947	948	949	994	995	996	997	998	999	1044	1045	1046	1047	1048	1049	
1444	3360	0	480	480	

